NO maps/textures/wall_1.xpm
F 0,0,255
EA maps/textures/wall_1.xpm
WE maps/textures/wall_1.xpm
C 220,61,0
SO maps/textures/wall_1.xpm

11111
100011111
100000001
10N011111
11111