NO ./maps/textures/wall_1.xpm
SO ./maps/textures/wall_1.xpm
WE ./maps/textures/wall_1.xpm
EA ./maps/textures/wall_1.xpm
F ./maps/textures/wall_1.xpm
C ./maps/textures/wall_1.xpm
DO ./maps/textures/wall_1.xpm
SP ./maps/textures/wall_1.xpm

1111111111111111111111111
1000001000000001000000001
100000100000000100P000001
1000001000000001000000001
1000001000100001000000001
1000001000100001000000001
100000000010000111D111111
1000000000100000000000001
1000000000100000S00000001
1000000000100000000000001
1111111111111111111111111
