NO maps/textures/wall_1.xpm
F 0,0,255
EA maps/textures/wall_1.xpm
WE maps/textures/wall_1.xpm
C 220,61,0
SO maps/textures/wall_1.xpm


        11111111111111111
        10000000000000001
        100000000000000011111111
        100000000000000000000001
11111111100000000000000000000001
10000000010000000000000000000001
10000000010000000000000000000001
1000000001000111000000000111111
1111110011000100000000001
1000000001000111111000001
10000000010001000N0000001
1000000000000100W0E000001
10000000000001000S0000001
1000000000000100000000001
1111111111111111111111111