NO maps/textures/wall_1.xpm
F 0,0,255
EA maps/textures/wall_1.xpm
WE maps/textures/wall_1.xpm
C 220,61,0
SO maps/textures/wall_1.xpm


        11111111111111111
        10000000000000001
        10000000000000001
1111111110000000000000001
1000000001000000000000001
1000000001000000000000001
1000000001000111000000001
1111110011000100000000001
1000000001000111111000001
10000000010001000N0000001
1000000000000100W0E000001
10000000000001000S0000001
1000000000000100000000001
1111111111111111111111111